+++++++++
+   S  ++
++++++ ++
+G+    ++
+  + + ++
++   + ++
+++++++++